60
17
13 13 13 13 13 13 13 13 13 13 13 13 13 13 13 13 13 13 13 13 13 13 13 13 13 13 13 13 13 13 13 13 9  0  0  0  0  0  0  0  0  0  0  0  0  8  13 13 13 13 13 13 13 13 13 13 13 13 13 13
13 11 11 8  13 9  11 11 11 11 13 9  11 11 11 11 11 11 11 11 11 11 8  13 9  11 11 11 11 11 8  13 9  0  0  0  0  0  0  0  0  0  0  0  0  8  13 9  11 11 11 8  13 9  8  13 9  11 8  13  
13 9  0  8  13 9  0  0  0  8  13 9  0  0  0  0  0  0  0  0  0  0  8  13 9  0  0  0  0  0  8  13 9  0  0  0  0  0  0  0  0  0  0  0  0  8  13 9  0  0  0  8  13 9  8  13 9  0  4  13  
13 5  2  8  13 9  0  0  0  8  13 9  0  0  0  0  0  0  0  0  0  0  8  13 9  0  0  0  0  0  8  13 9  0  0  0  0  0  0  0  0  0  0  0  0  8  13 9  0  0  0  8  13 9  0  11 0  6  14 13  
13 14 14 7  13 9  0  0  0  8  13 9  0  0  0  0  0  0  0  0  0  0  8  13 9  0  0  0  0  0  8  13 9  0  0  0  0  0  0  0  0  0  0  0  0  8  13 9  0  0  0  8  13 9  0  2  0  0  11 13  
13 9  0  8  13 9  0  0  0  8  13 9  0  0  0  0  0  0  0  0  0  0  8  13 9  0  0  0  0  0  8  13 13 13 13 13 13 13 13 13 13 13 13 13 13 13 13 9  0  0  0  0  11 0  6  14 7  0  8  13  
13 9  2  4  13 9  0  0  0  8  13 9  0  0  0  0  0  0  0  0  0  0  8  13 9  0  0  0  0  0  0  11 11 13 11 13 11 13 11 13 11 13 11 13 11 13 13 9  0  0  2  2  2  0  0  11 0  0  8  13  
13 6  14 14 13 9  0  0  0  8  13 9  0  0  0  0  0  0  0  0  0  0  8  13 9  0  0  0  0  0  0  2  0  11 0  11 0  11 0  11 0  11 0  11 0  11 11 0  2  6  14 14 14 7  0  0  0  0  8  13  
13 9  11 11 13 9  0  0  0  8  13 9  0  0  0  0  0  0  0  0  0  0  8  13 9  0  0  0  0  0  6  14 5  2  2  2  2  2  2  2  2  2  2  2  2  2  2  4  14 7  0  8  13 9  0  0  0  0  8  13                      
13 5  2  8  13 9  0  0  0  8  13 9  0  0  0  0  0  0  0  0  0  0  8  13 9  0  0  0  2  0  8  13 14 14 14 14 14 14 14 14 14 14 14 14 14 14 14 14 13 5  0  8  13 9  0  0  0  0  8  13  
13 14 14 7  13 13 13 13 13 13 13 13 0  0  0  0  0  0  0  0  0  0  8  13 9  0  0  6  14 7  8  13 0  0  0  0  0  0  0  0  0  0  0  0  0  0  0  0  13 14 7  8  13 9  0  0  0  0  8  13    
13 9  0  8  13 9  11 11 11 11 11 13 0  0  0  0  0  0  0  0  0  0  8  13 9  0  0  4  13 5  4  13 0  14 14 14 9  14 14 14 14 14 0  14 0  0  14 0  13 13 5  8  13 9  0  0  0  0  8  13  
13 9  2  4  13 9  2  0  2  0  4  13 13 13 13 13 13 13 13 13 13 13 13 13 9  0  6  14 13 14 14 13 0  13 9  13 5  0  0  13 0  0  0  13 0  0  13 0  13 13 14 7  11 0  0  0  0  0  8  13  
13 6  14 14 13 9  14 6  14 7  14 13 0  11 11 13 11 11 11 13 11 11 11 13 9  0  4  13 13 0  0  0  0  13 13 13 14 9  0  13 0  0  0  13 13 13 13 0  13 13 13 5  0  0  0  0  0  0  8  13  
13 9  11 11 11 0  11 0  11 0  11 11 0  2  0  11 0  2  0  11 0  2  0  11 0  6  14 13 13 0  0  0  0  13 9  8  13 9  0  13 0  0  0  13 0  0  13 0  13 13 13 14 7  0  0  0  0  0  8  13                   
13 5  2  2  2  2  2  2  2  2  2  2  4  14 5  2  4  14 5  2  4  14 5  2  2  4  13 13 13 0  0  0  0  13 13 13 13 9  0  13 0  0  0  13 0  0  13 0  13 13 13 13 5  2  2  2  2  2  4  13  
13 14 14 14 14 14 14 14 14 14 14 14 14 13 14 14 14 13 14 14 14 13 14 14 14 14 13 13 13 13 13 13 13 14 14 14 14 14 14 14 14 14 14 14 14 14 14 13 13 13 13 13 14 14 14 14 14 14 14 13