60
17
13 9  13 13 13 13 13 13 13 13 13 13 13 13 13 13 13 13 13 13 13 13 13 13 13 13 13 13 13 13 13 13 13 13 13 13 13 13 13 13 13 13 13 13 13 13 13 13 13 13 13 13 13 13 13 13 13 13 13 13
13 9  13 0  13 0  8  13 9  8  13 9  8  13 9  8  13 9  8  13 9  0  13 0  13 0  0  8  13 0  13 0  13 0  13 0  13 0  13 9  13 0  13 0  8  13 9  0  0  8  13 9  0  0  0  0  0  0  8  13  
13 9  13 0  13 0  8  13 9  8  13 9  8  13 9  8  13 9  8  13 9  0  13 0  13 0  0  8  13 0  13 0  13 0  13 0  13 0  13 9  13 0  13 0  8  13 9  0  0  8  13 9  0  0  0  0  0  0  8  13 
13 9  13 0  13 0  8  13 9  8  13 9  8  13 9  8  13 9  8  13 9  0  13 0  13 0  0  8  13 0  13 0  13 0  13 0  13 0  13 9  13 0  13 0  8  13 9  0  0  8  13 9  0  0  0  0  0  0  4  13 
13 9  13 0  13 0  8  13 9  8  13 9  8  13 9  0  11 0  8  13 9  0  13 0  13 0  0  8  13 0  13 0  13 0  13 0  13 0  13 9  13 0  13 0  8  13 9  0  0  8  13 9  0  0  0  0  0  6  14 13
13 9  11 0  11 0  0  11 0  0  11 0  0  11 0  0  2  0  0  11 0  0  11 0  11 0  0  8  13 0  13 0  13 0  13 0  13 0  13 9  13 0  13 0  8  13 9  0  0  8  13 9  0  0  0  0  0  2  11 13  
13 9  0  0  2  0  0  2  0  0  2  0  0  2  0  6  14 7  0  2  0  0  2  0  0  0  0  8  13 13 13 13 13 13 13 13 13 13 13 9  13 0  13 0  8  13 9  0  0  8  13 13 9  0  0  0  6  14 7  13
13 5  0  6  14 7  6  14 7  6  14 7  6  14 7  0  11 0  6  14 7  6  14 7  0  0  0  0  11 11 11 11 11 11 11 11 11 11 11 0  13 0  11 0  8  13 9  0  0  0  8  13 9  0  2  0  0  11 0  13 
13 14 7  0  11 0  0  11 0  0  11 0  0  11 0  0  0  0  0  11 0  0  11 0  0  0  0  0  2  0  2  0  2  0  2  0  2  0  2  0  13 0  2  0  0  11 0  0  0  0  0  11 0  6  14 7  0  0  0  13                     
13 13 5  0  0  0  0  0  0  0  0  0  0  0  0  0  0  0  0  0  0  0  0  0  0  0  0  6  14 0  14 0  14 0  14 0  14 0  14 7  11 6  14 7  0  2  0  0  2  0  0  2  0  0  11 0  0  0  0  13  
13 13 14 7  0  0  0  0  0  0  0  0  0  0  0  0  0  0  0  0  0  0  0  0  0  0  2  0  11 0  11 0  11 0  11 0  11 0  11 0  2  0  11 0  6  14 7  6  14 7  6  14 7  0  0  0  0  0  0  13   
13 13 13 5  0  0  0  0  0  0  0  0  0  0  0  0  0  0  0  0  0  0  0  0  0  6  14 7  0  0  0  0  0  0  0  0  0  0  2  6  14 7  0  0  0  11 0  0  11 0  0  11 0  0  0  0  0  0  0  13  
13 13 13 14 7  0  0  0  0  0  0  0  0  0  0  0  0  0  0  0  0  0  0  0  0  0  11 0  0  0  0  0  0  0  0  0  0  6  14 7  11 0  0  0  0  0  0  0  0  0  0  0  0  0  0  0  0  0  0  13  
13 13 13 13 5  0  0  0  0  0  0  0  0  0  0  0  0  0  0  0  0  0  0  0  0  0  0  0  0  0  0  0  0  0  0  0  0  0  11 0  0  0  0  0  0  0  0  0  0  0  0  0  0  0  0  0  0  0  0  13  
13 13 13 13 14 7  0  0  0  0  0  0  0  0  0  0  0  0  0  0  0  0  0  0  0  0  0  0  0  0  0  0  0  0  0  0  0  0  0  0  0  0  0  0  0  0  0  0  0  0  0  0  0  0  0  0  0  0  0  13                   
13 13 13 13 13 5  2  2  2  2  2  2  2  2  2  2  2  2  2  2  2  2  2  2  2  2  2  2  2  2  2  2  2  2  2  2  2  2  2  2  2  2  2  2  2  2  2  2  2  2  2  2  2  2  2  2  2  2  4  13  
13 13 13 13 13 14 14 14 14 14 14 14 14 14 14 14 14 14 14 14 14 14 14 14 14 14 14 14 14 14 14 14 14 14 14 14 14 14 14 14 14 14 14 14 14 14 14 14 14 14 14 14 14 14 14 14 14 14 14 13